401000000000
000000000000
l00300000000
000001000000
l00000000000
000000300000
l0040100u010
000000000000
30200030d020
000000000000