000004010
000000000
00d0200r0
400000000
0000000r0
l00000000
0000000r0
300000000
00u0100r0
000000000
000003020
000000000